30 30 30 30 30 30 30 30 30 30 30 30 30 30 30 30 30 30 30 30 30 30 30 30 30 30 30 30 30 30 30 30 30 30 30 30 30 30 30 30 30 30 30 30 30 30 30 30 30 30 
30 30 30 30 30 30 30 30 30 30 30 30 30 30 30 30 30 30 30 30 30 30 30 30 30 30 30 30 30 30 30 30 30 30 30 30 30 30 30 30 30 30 30 30 30 30 30 30 30 30 
30 30 30 30 30 30 30 30 30 30 30 30 30 30 30 30 30 30 30 30 30 30 30 30 30 30 30 30 30 30 30 30 30 30 30 30 30 30 30 30 30 30 30 30 30 30 30 30 30 30 
30 30 30 30 30 30 30 30 30 30 30 30 30 30 30 30 30 30 30 30 30 30 30 30 30 30 30 30 30 30 30 30 30 30 30 30 30 30 30 30 30 30 30 30 30 30 30 30 30 30 
30 30 30 30 30 30 30 30 30 30 30 30 30 30 30 30 30 30 30 30 30 30 30 30 30 30 30 30 30 30 30 30 30 30 30 30 30 30 30 30 30 30 30 30 30 30 30 30 30 30 
30 30 30 30 30 30 30 30 30 30 30 30 30 30 30 30 30 30 30 30 30 30 30 30 30 30 30 30 30 30 30 30 30 30 30 30 30 30 30 30 30 30 30 30 30 30 30 30 30 30 
30 30 30 30 30 30 30 30 30 30 30 30 30 30 30 30 30 30 30 30 30 30 30 30 30 30 30 30 30 30 30 30 30 30 30 30 30 30 30 30 30 30 30 30 30 30 30 30 30 30 
30 30 30 30 30 30 30 30 30 30 30 30 30 30 30 30 30 30 30 30 30 30 30 30 30 30 30 30 30 30 30 30 30 30 30 30 30 30 30 30 30 30 30 30 30 30 30 30 30 30 
30 30 30 30 30 30 30 30 30 30 30 30 30 30 30 30 30 30 30 30 30 30 30 30 30 30 30 30 30 30 30 30 30 30 30 30 30 30 30 30 30 30 30 30 30 30 30 30 30 30 
30 30 30 30 30 30 30 30 30 30 30 30 30 30 30 30 30 30 30 30 30 30 30 30 30 30 30 30 30 30 30 30 30 30 30 30 30 30 30 30 30 30 30 30 30 30 30 30 30 30 
30 30 30 30 30 30 30 30 30 30 6 7 7 7 7 7 7 7 7 7 7 7 7 7 7 7 7 7 7 7 7 7 7 7 7 7 7 7 7 8 30 30 30 30 30 30 30 30 30 30 
30 30 30 30 30 30 30 30 30 30 11 22 22 22 22 22 22 22 22 22 22 22 22 22 22 22 22 22 22 22 21 22 22 21 21 22 22 22 22 13 30 30 30 30 30 30 30 30 30 30 
30 30 30 30 30 30 30 30 30 30 11 22 22 22 22 22 22 22 22 22 22 22 21 20 20 22 21 20 20 22 22 22 21 22 21 22 22 21 22 13 30 30 30 30 30 30 30 30 30 30 
30 30 30 30 30 30 30 30 30 30 11 22 20 20 20 20 20 21 21 22 22 20 20 22 22 22 22 22 22 20 20 22 22 1 1 1 22 21 22 13 30 30 30 30 30 30 30 30 30 30 
30 30 30 30 30 30 30 30 30 30 11 22 22 22 22 22 22 22 22 22 22 20 20 22 1 1 1 22 22 21 21 22 22 1 4 1 22 21 20 13 30 30 30 30 30 30 30 30 30 30 
30 30 30 30 30 30 30 30 30 30 11 22 22 22 22 22 22 22 22 22 22 22 22 22 1 1 1 22 20 20 20 22 22 1 5 1 22 20 20 13 30 30 30 30 30 30 30 30 30 30 
30 30 30 30 30 30 30 30 30 30 11 22 22 4 4 4 4 4 4 4 4 4 4 4 4 5 1 22 22 20 20 21 22 22 5 22 22 20 21 13 30 30 30 30 30 30 30 30 30 30 
30 30 30 30 30 30 30 30 30 30 11 22 22 22 22 22 20 20 20 22 22 22 20 20 22 5 1 22 21 20 20 21 22 22 5 21 21 20 22 13 30 30 30 30 30 30 30 30 30 30 
30 30 30 30 30 30 30 30 30 30 11 22 21 21 22 20 20 22 21 21 21 22 20 20 22 5 1 22 21 21 20 22 22 21 5 22 20 20 22 13 30 30 30 30 30 30 30 30 30 30 
30 30 30 30 30 30 30 30 30 30 11 22 21 22 21 21 20 22 20 20 20 21 21 21 22 5 1 22 22 22 22 20 22 21 5 22 20 20 21 13 30 30 30 30 30 30 30 30 30 30 
30 30 30 30 30 30 30 30 30 30 11 22 22 21 22 21 20 20 20 20 20 21 22 21 22 5 21 22 21 21 21 20 21 21 5 21 20 21 21 13 30 30 30 30 30 30 30 30 30 30 
30 30 30 30 30 30 30 30 30 30 11 22 21 22 20 20 20 21 22 22 21 21 21 21 22 5 21 21 21 21 20 20 20 21 5 21 20 20 22 13 30 30 30 30 30 30 30 30 30 30 
30 30 30 30 30 30 30 30 30 30 11 22 22 22 22 22 22 22 22 22 21 22 22 22 22 5 22 22 22 21 21 20 20 21 5 22 20 20 22 13 30 30 30 30 30 30 30 30 30 30 
30 30 30 30 30 30 30 30 30 30 11 1 1 1 1 1 1 1 1 22 21 22 1 1 1 5 1 22 22 22 22 21 21 21 5 22 20 20 22 13 30 30 30 30 30 30 30 30 30 30 
30 30 30 30 30 30 30 30 30 30 11 4 4 4 4 4 4 4 4 4 4 4 4 4 4 4 4 4 4 4 4 4 4 4 4 20 20 20 21 13 30 30 30 30 30 30 30 30 30 30 
30 30 30 30 30 30 30 30 30 30 11 1 1 1 1 1 1 1 1 22 22 22 1 1 5 1 1 22 22 22 20 22 22 21 5 22 20 20 21 13 30 30 30 30 30 30 30 30 30 30 
30 30 30 30 30 30 30 30 30 30 11 22 22 22 21 21 1 22 22 22 21 22 22 22 5 22 22 22 21 22 20 21 20 20 5 20 20 21 21 13 30 30 30 30 30 30 30 30 30 30 
30 30 30 30 30 30 30 30 30 30 11 22 21 21 21 21 1 22 21 21 21 21 22 22 5 22 22 21 20 20 20 20 20 20 5 22 20 21 22 13 30 30 30 30 30 30 30 30 30 30 
30 30 30 30 30 30 30 30 30 30 11 21 22 22 21 22 1 21 21 22 21 21 21 22 5 21 20 20 20 20 21 21 22 20 5 21 20 22 22 13 30 30 30 30 30 30 30 30 30 30 
30 30 30 30 30 30 30 30 30 30 11 21 21 20 20 22 1 21 22 22 22 21 21 22 5 22 22 20 20 20 20 20 22 21 5 22 21 20 22 13 30 30 30 30 30 30 30 30 30 30 
30 30 30 30 30 30 30 30 30 30 11 21 20 20 20 22 1 22 21 21 22 21 21 22 5 22 20 20 22 21 22 20 20 20 5 22 22 20 22 13 30 30 30 30 30 30 30 30 30 30 
30 30 30 30 30 30 30 30 30 30 11 22 22 22 20 20 1 22 1 1 1 1 1 1 5 22 22 21 21 21 22 22 22 22 5 22 21 22 1 13 30 30 30 30 30 30 30 30 30 30 
30 30 30 30 30 30 30 30 30 30 11 22 1 22 20 20 4 4 4 4 4 4 4 4 4 4 5 22 20 4 4 4 4 4 5 1 1 1 1 13 30 30 30 30 30 30 30 30 30 30 
30 30 30 30 30 30 30 30 30 30 11 22 1 22 22 22 1 22 21 21 21 1 22 22 22 22 5 20 20 5 22 21 22 22 22 22 21 21 1 13 30 30 30 30 30 30 30 30 30 30 
30 30 30 30 30 30 30 30 30 30 11 21 1 22 21 22 1 22 20 20 21 1 22 20 20 22 5 20 22 5 22 21 21 21 21 20 21 22 1 13 30 30 30 30 30 30 30 30 30 30 
30 30 30 30 30 30 30 30 30 30 11 20 1 21 21 21 1 22 20 20 22 1 22 20 20 20 4 4 4 4 22 21 20 20 21 22 21 22 1 13 30 30 30 30 30 30 30 30 30 30 
30 30 30 30 30 30 30 30 30 30 11 20 1 1 1 1 1 22 20 20 22 1 22 20 20 20 20 20 22 1 22 20 20 20 20 21 21 22 1 13 30 30 30 30 30 30 30 30 30 30 
30 30 30 30 30 30 30 30 30 30 11 21 21 21 20 20 22 20 20 20 22 21 21 22 20 20 20 20 22 1 21 22 21 20 20 22 21 21 1 13 30 30 30 30 30 30 30 30 30 30 
30 30 30 30 30 30 30 30 30 30 11 22 22 20 20 20 21 20 21 22 1 1 1 1 1 1 1 1 1 1 22 21 22 22 22 21 21 21 1 13 30 30 30 30 30 30 30 30 30 30 
30 30 30 30 30 30 30 30 30 30 16 17 17 17 17 17 17 17 17 17 17 17 17 17 17 17 17 17 17 17 17 17 17 17 17 17 17 17 17 18 30 30 30 30 30 30 30 30 30 30 
30 30 30 30 30 30 30 30 30 30 30 30 30 30 30 30 30 30 30 30 30 30 30 30 30 30 30 30 30 30 30 30 30 30 30 30 30 30 30 30 30 30 30 30 30 30 30 30 30 30 
30 30 30 30 30 30 30 30 30 30 30 30 30 30 30 30 30 30 30 30 30 30 30 30 30 30 30 30 30 30 30 30 30 30 30 30 30 30 30 30 30 30 30 30 30 30 30 30 30 30 
30 30 30 30 30 30 30 30 30 30 30 30 30 30 30 30 30 30 30 30 30 30 30 30 30 30 30 30 30 30 30 30 30 30 30 30 30 30 30 30 30 30 30 30 30 30 30 30 30 30 
30 30 30 30 30 30 30 30 30 30 30 30 30 30 30 30 30 30 30 30 30 30 30 30 30 30 30 30 30 30 30 30 30 30 30 30 30 30 30 30 30 30 30 30 30 30 30 30 30 30 
30 30 30 30 30 30 30 30 30 30 30 30 30 30 30 30 30 30 30 30 30 30 30 30 30 30 30 30 30 30 30 30 30 30 30 30 30 30 30 30 30 30 30 30 30 30 30 30 30 30 
30 30 30 30 30 30 30 30 30 30 30 30 30 30 30 30 30 30 30 30 30 30 30 30 30 30 30 30 30 30 30 30 30 30 30 30 30 30 30 30 30 30 30 30 30 30 30 30 30 30 
30 30 30 30 30 30 30 30 30 30 30 30 30 30 30 30 30 30 30 30 30 30 30 30 30 30 30 30 30 30 30 30 30 30 30 30 30 30 30 30 30 30 30 30 30 30 30 30 30 30 
30 30 30 30 30 30 30 30 30 30 30 30 30 30 30 30 30 30 30 30 30 30 30 30 30 30 30 30 30 30 30 30 30 30 30 30 30 30 30 30 30 30 30 30 30 30 30 30 30 30 
30 30 30 30 30 30 30 30 30 30 30 30 30 30 30 30 30 30 30 30 30 30 30 30 30 30 30 30 30 30 30 30 30 30 30 30 30 30 30 30 30 30 30 30 30 30 30 30 30 30 
30 30 30 30 30 30 30 30 30 30 30 30 30 30 30 30 30 30 30 30 30 30 30 30 30 30 30 30 30 30 30 30 30 30 30 30 30 30 30 30 30 30 30 30 30 30 30 30 30 30 
