30 30 30 30 30 30 30 30 30 30 30 30 30 30 30 30 30 30 30 30 30 30 30 30 30 30 30 30 30 30 30 30 30 30 30 30 30 30 30 30 30 30 30 30 30 30 30 30 30 30 
30 30 30 30 30 30 30 30 30 30 30 30 30 30 30 30 30 30 30 30 30 30 30 30 30 30 30 30 30 30 30 30 30 30 30 30 30 30 30 30 30 30 30 30 30 30 30 30 30 30 
30 30 30 30 30 30 30 30 30 30 30 30 30 30 30 30 30 30 30 30 30 30 30 30 30 30 30 30 30 30 30 30 30 30 30 30 30 30 30 30 30 30 30 30 30 30 30 30 30 30 
30 30 30 30 30 30 30 30 30 30 30 30 30 30 30 30 30 30 30 30 30 30 30 30 30 30 30 30 30 30 30 30 30 30 30 30 30 30 30 30 30 30 30 30 30 30 30 30 30 30 
30 30 30 30 30 30 30 30 30 30 30 30 30 30 30 30 30 30 30 30 30 30 30 30 30 30 30 30 30 30 30 30 30 30 30 30 30 30 30 30 30 30 30 30 30 30 30 30 30 30 
30 30 30 30 30 30 30 30 30 30 30 30 30 30 30 30 30 30 30 30 30 30 30 30 30 30 30 30 30 30 30 30 30 30 30 30 30 30 30 30 30 30 30 30 30 30 30 30 30 30 
30 30 30 30 30 30 30 30 30 30 30 30 30 30 30 30 30 30 30 30 30 30 30 30 30 30 30 30 30 30 30 30 30 30 30 30 30 30 30 30 30 30 30 30 30 30 30 30 30 30 
30 30 30 30 30 30 30 30 30 30 6 7 7 7 7 7 7 7 7 7 7 7 7 7 7 7 7 7 7 7 7 7 7 7 7 7 7 7 7 8 30 30 30 30 30 30 30 30 30 30 
30 30 30 30 30 30 30 30 30 30 11 22 22 22 22 22 22 22 22 22 22 22 22 22 22 22 22 4 4 4 4 4 4 4 1 22 1 1 1 13 30 30 30 30 30 30 30 30 30 30 
30 30 30 30 30 30 30 30 30 30 11 1 27 27 27 27 27 27 27 27 27 27 27 27 27 22 22 22 22 22 22 22 22 4 4 5 4 4 1 13 30 30 30 30 30 30 30 30 30 30 
30 30 30 30 30 30 30 30 30 30 11 20 21 22 22 22 21 22 21 22 22 27 27 21 27 21 22 20 21 22 22 21 22 22 21 21 22 4 22 13 30 30 30 30 30 30 30 30 30 30 
30 30 30 30 30 30 30 30 30 30 11 22 22 21 20 22 22 20 21 21 20 27 27 22 5 22 22 1 1 1 1 22 22 1 1 1 4 4 1 13 30 30 30 30 30 30 30 30 30 30 
30 30 30 30 30 30 30 30 30 30 11 1 1 22 22 1 1 1 1 1 22 5 21 22 4 1 22 1 4 4 1 21 20 4 4 4 4 4 4 13 30 30 30 30 30 30 30 30 30 30 
30 30 30 30 30 30 30 30 30 30 11 1 27 4 4 4 27 27 27 27 27 27 22 22 4 4 4 4 4 4 4 21 21 4 22 21 20 22 20 13 30 30 30 30 30 30 30 30 30 30 
30 30 30 30 30 30 30 30 30 30 11 1 27 20 22 21 20 22 22 21 20 20 22 22 20 21 20 22 21 4 1 20 22 4 1 22 22 21 20 13 30 30 30 30 30 30 30 30 30 30 
30 30 30 30 30 30 30 30 30 30 11 1 27 22 20 22 22 20 22 22 22 21 21 20 22 22 22 21 22 4 1 22 21 4 4 4 4 4 1 13 30 30 30 30 30 30 30 30 30 30 
30 30 30 30 30 30 30 30 30 30 11 27 27 22 21 1 1 22 21 4 21 4 4 4 22 1 1 1 22 4 4 22 22 20 21 22 22 4 4 13 30 30 30 30 30 30 30 30 30 30 
30 30 30 30 30 30 30 30 30 30 11 27 27 22 1 1 1 20 22 4 4 4 22 4 5 4 4 4 22 1 4 21 20 22 22 22 21 22 4 13 30 30 30 30 30 30 30 30 30 30 
30 30 30 30 30 30 30 30 30 30 11 1 27 5 27 27 27 21 20 20 21 22 20 21 22 22 4 4 21 1 4 22 22 1 4 4 4 4 4 13 30 30 30 30 30 30 30 30 30 30 
30 30 30 30 30 30 30 30 30 30 11 21 20 22 21 21 27 22 20 22 20 22 20 22 22 1 4 4 22 1 4 22 21 4 4 21 22 21 20 13 30 30 30 30 30 30 30 30 30 30 
30 30 30 30 30 30 30 30 30 30 11 22 21 22 22 22 27 22 21 1 1 22 21 1 4 4 4 4 21 1 4 22 22 5 22 22 22 22 20 13 30 30 30 30 30 30 30 30 30 30 
30 30 30 30 30 30 30 30 30 30 11 21 20 21 22 20 27 22 22 1 1 21 22 4 4 21 4 4 4 4 4 1 1 4 1 22 21 20 22 13 30 30 30 30 30 30 30 30 30 30 
30 30 30 30 30 30 30 30 30 30 11 22 20 21 21 20 27 21 22 1 1 20 22 4 22 22 4 4 4 4 4 4 4 4 4 1 20 22 21 13 30 30 30 30 30 30 30 30 30 30 
30 30 30 30 30 30 30 30 30 30 11 1 1 1 1 1 4 22 22 22 1 22 21 22 21 20 20 1 1 1 1 1 1 1 4 4 1 20 22 13 30 30 30 30 30 30 30 30 30 30 
30 30 30 30 30 30 30 30 30 30 11 4 4 4 4 4 4 4 4 4 27 22 20 22 22 20 20 22 20 20 20 22 20 21 4 4 4 20 20 13 30 30 30 30 30 30 30 30 30 30 
30 30 30 30 30 30 30 30 30 30 11 5 1 1 1 1 1 1 1 22 5 21 20 20 22 20 20 21 22 21 22 22 20 22 4 22 4 4 1 13 30 30 30 30 30 30 30 30 30 30 
30 30 30 30 30 30 30 30 30 30 11 5 22 21 22 20 20 21 22 20 4 1 20 20 22 22 1 1 1 1 1 1 4 4 4 20 21 4 4 13 30 30 30 30 30 30 30 30 30 30 
30 30 30 30 30 30 30 30 30 30 11 4 1 22 21 1 20 22 20 1 4 4 21 22 22 1 4 4 4 4 4 4 4 20 22 20 22 21 4 13 30 30 30 30 30 30 30 30 30 30 
30 30 30 30 30 30 30 30 30 30 11 4 1 22 22 1 1 20 1 4 4 4 22 22 1 4 4 4 4 4 21 20 21 20 21 20 22 20 22 13 30 30 30 30 30 30 30 30 30 30 
30 30 30 30 30 30 30 30 30 30 11 4 1 20 1 4 4 4 4 4 4 4 4 4 4 4 4 4 4 4 4 22 22 21 21 21 20 20 22 13 30 30 30 30 30 30 30 30 30 30 
30 30 30 30 30 30 30 30 30 30 11 4 4 1 4 4 21 22 22 22 21 22 20 22 21 21 1 1 1 4 4 4 4 4 22 22 20 20 21 13 30 30 30 30 30 30 30 30 30 30 
30 30 30 30 30 30 30 30 30 30 11 4 4 4 4 22 22 20 22 1 1 1 21 22 22 21 22 22 22 22 22 4 4 4 4 22 21 22 20 13 30 30 30 30 30 30 30 30 30 30 
30 30 30 30 30 30 30 30 30 30 11 20 20 22 21 20 22 21 1 4 4 4 1 1 1 1 1 1 1 1 1 22 21 4 4 1 22 21 22 13 30 30 30 30 30 30 30 30 30 30 
30 30 30 30 30 30 30 30 30 30 11 22 21 20 22 20 22 1 4 4 4 4 4 4 4 4 4 4 4 4 4 4 4 4 4 4 1 22 22 13 30 30 30 30 30 30 30 30 30 30 
30 30 30 30 30 30 30 30 30 30 11 22 22 21 21 22 12 4 4 4 4 4 4 4 4 4 4 4 4 4 4 4 4 4 4 4 1 1 21 13 30 30 30 30 30 30 30 30 30 30 
30 30 30 30 30 30 30 30 30 30 11 21 22 22 20 1 4 4 4 1 1 1 1 1 1 1 1 1 4 1 21 1 4 4 4 4 4 4 1 13 30 30 30 30 30 30 30 30 30 30 
30 30 30 30 30 30 30 30 30 30 11 22 22 22 1 4 4 4 1 22 22 21 22 21 22 22 21 1 4 22 20 21 1 1 1 1 21 4 4 13 30 30 30 30 30 30 30 30 30 30 
30 30 30 30 30 30 30 30 30 30 11 22 21 1 4 4 4 12 20 22 20 22 20 22 22 21 20 22 1 22 22 22 22 21 20 22 22 1 4 13 30 30 30 30 30 30 30 30 30 30 
30 30 30 30 30 30 30 30 30 30 11 1 1 4 4 4 1 20 21 22 5 5 4 21 22 20 1 1 4 1 21 20 1 22 22 22 21 20 5 13 30 30 30 30 30 30 30 30 30 30 
30 30 30 30 30 30 30 30 30 30 11 4 4 4 4 1 22 22 22 22 1 4 1 22 22 20 1 1 4 1 22 21 1 1 20 1 22 1 4 13 30 30 30 30 30 30 30 30 30 30 
30 30 30 30 30 30 30 30 30 30 11 4 4 4 1 1 21 22 22 21 4 1 1 1 1 1 4 4 4 1 22 22 1 4 4 4 5 4 4 13 30 30 30 30 30 30 30 30 30 30 
30 30 30 30 30 30 30 30 30 30 16 17 17 17 17 17 17 17 17 17 17 17 17 17 17 17 17 17 17 17 17 17 17 17 17 17 17 17 17 18 30 30 30 30 30 30 30 30 30 30 
30 30 30 30 30 30 30 30 30 30 30 30 30 30 30 30 30 30 30 30 30 30 30 30 30 30 30 30 30 30 30 30 30 30 30 30 30 30 30 30 30 30 30 30 30 30 30 30 30 30 
30 30 30 30 30 30 30 30 30 30 30 30 30 30 30 30 30 30 30 30 30 30 30 30 30 30 30 30 30 30 30 30 30 30 30 30 30 30 30 30 30 30 30 30 30 30 30 30 30 30 
30 30 30 30 30 30 30 30 30 30 30 30 30 30 30 30 30 30 30 30 30 30 30 30 30 30 30 30 30 30 30 30 30 30 30 30 30 30 30 30 30 30 30 30 30 30 30 30 30 30 
30 30 30 30 30 30 30 30 30 30 30 30 30 30 30 30 30 30 30 30 30 30 30 30 30 30 30 30 30 30 30 30 30 30 30 30 30 30 30 30 30 30 30 30 30 30 30 30 30 30 
30 30 30 30 30 30 30 30 30 30 30 30 30 30 30 30 30 30 30 30 30 30 30 30 30 30 30 30 30 30 30 30 30 30 30 30 30 30 30 30 30 30 30 30 30 30 30 30 30 30 
30 30 30 30 30 30 30 30 30 30 30 30 30 30 30 30 30 30 30 30 30 30 30 30 30 30 30 30 30 30 30 30 30 30 30 30 30 30 30 30 30 30 30 30 30 30 30 30 30 30 
30 30 30 30 30 30 30 30 30 30 30 30 30 30 30 30 30 30 30 30 30 30 30 30 30 30 30 30 30 30 30 30 30 30 30 30 30 30 30 30 30 30 30 30 30 30 30 30 30 30 
30 30 30 30 30 30 30 30 30 30 30 30 30 30 30 30 30 30 30 30 30 30 30 30 30 30 30 30 30 30 30 30 30 30 30 30 30 30 30 30 30 30 30 30 30 30 30 30 30 30 
